######################
S+++++++++++++++++++++
################+#####
################+#####
################+#####
################+#####
################+#####
################+#####
################+#####
################+#####
################+#####
################+#####
################+#####
################+#####
################+#####
################+#####
###########++++++#####
###########+####+#####
###########+####+#####
###########+####+#####
###########++++++#####
######################