S ###################
    # #   #   # #  T#
### # ### # ### ### #
# #   # # # #   # # #
# ### # # # # ### # #
#     #   # #       #
### ### ### ### #####
#     #   #       # #
# ####### ##### # # #
#   #   #       #   #
# ### # # ####### ###
#     #         #   #
# # ####### #########
# #       # #       #
### # ### ### # # # #
#   # # # #   # # # #
# ### # # # ### ### #
# # # #     # # #   #
# # # ##### # ##### #
# #   #         #   
################### K
