S ###################
## #  #  #    #   # #
#   #  ###  #   #  T#
# ######   #######  #
#      # #       #  #
###### #######  ##  #
#       #        #  #
##### #    ##### #  #
#       #      ######
# ##### ###         #
# #   # #  #        #
# # # #   #         #
# # # #####         #
#   ##              #
#### # ####         #
#    #              #
## ### #            #
#  #   #            #
#    ##########     #
#  ###    #   #     #
#      ##   #K#     #
#####################