######################
#S    #              #
#  #  ####  #######  #
#  #        #  #     #
#  ##########  #  ####
#  #     #           #
#  #  #  #############
#     #  #           #
#  ####  #  #######  #
#  #  #        #     #
#  #  ##########  #  #
#     #           #  #
####  #  ##########  #
#  #  #        #     #
#  #  #######  ####  #
#     #     #     #  #
#  ####  #######  ####
#  #  #        #     #
#  #  #######  ####  #
#          K#        #
######################