      ###############
    # #   #   # #  S#
### # ### # ### ### #
# #   # # # #   # # #
#    T    # # ### # #
#     #   # #       #
#                   #
#     #   #       # #
# ####### ##### # # #
#   #   #       #   #
#                   #
#     #    K    #   #
# #                 #
# #       # #       #
###                 #
#   # # # #   # # # #
# ###               #
# # # #     # # #   #
# # # ##### # ##### #
# #   #         #   
###################  
